WWWWWWWWWWWWWWWWWWWW
W                  W
W WWWW WWW WW WWWW W
W WWWW WWW WW WWWW W
W W     WW W     W W
W W WWW WW W WWW W W
W W WWW WW W WWW W W
W W WW        WW W W
W W WW WW WWW WW W W
W      W    W      W
W W WW WWWWWW WW W W
W W WW        WW W W
W W WWW W WW WWW W W
W W WWW W WW WWW W W
W W     W WW     W W
W WWWW WW WWW WWWW W
W WWWW WW WWW WWWW W
W                  W
WWWWWWWWWWWWWWWWWWWW